7 9
1 1 1 1 1 0 0
1 2 5 2 1 0 0
1 2 2 2 1 0 0
1 2 2 2 1 1 1
1 2 2 4 2 3 1
1 2 4 2 1 1 1
1 1 2 1 1 0 0
0 1 3 1 0 0 0
0 1 1 1 0 0 0